0000000000000000000000000000000000000000000000000000000000000000000000000000000000000000000000000000000000000000000000
0000000000000000000000000000000000000000000000000000000000000000000000000000000000000000000000000000000000000000000000
0000000000000000000000000000000000000000000000000000000000000000000000000000000000000000000000000000000000000000000000
0000000000000000000000000000000000000000000000000000000000000000000000000000000000000000000000000000000000000000000000
0000000000000000011111000000000000000000000000000000000000000000001000100010001000111110000000000000000000000000000000
0000000000000000000000000000000000000000000000000000000000000000001000100010001000000010000000000000000000000000000000
0022222220000000000000000000000000000000000000222222222222222220001000100010001000000010000000000000000000000000000000
0000000000000000000000000000000000000000000000000000000000000000001111100010001000000010000000000000000000000000000000
0000000000000000000000000002222222222222000000000000000000000000001000100010001000100010000000000000000000000000000000
0000000000000000222222222221111111111111000000000000000000000000001000100011111000011110000000000000000000000000000000
0000000000000002111111111111111111111111110000000000000000000000000000000000000000000000000000000000000000000000000000
0000000000002221111111111111111111111111111110000000000000000000000000000000000000000000000000000000000000000000000000
0000000000221111111111111111111111111111111110000000000000000000000000000000000000000000000000000000000000000000000000
