00000000000000000000000000000000000000000000000000000000000
00000000000000000000000000000000000000000000000000000000000
00000000000000000000000000000000000000000000000000000000000
00000000000000000000000000000000000000000000000000000000000
00000000000000000000000000000000000000000000000000000000000
00000000000000000000000000000000000000000000000000000000000
00222222200000000000000000000000000000000000002222222200000
00000000000000000000000000000000000000000000000000000000000
00000000000000000000000000022222222222220000000000000000000
00000000000000002222222222211111111111110000000000000000000
00000000000000021111111111111111111111111100000000000000000
00000000000022211111111111111111111111111111100000000000000
00000000002211111111111111111111111111111111100000000000000
